10x10
0011100000
0000100000
0000110000
0000010000
0000010000
0001110000
0111000000
0010000000
0110000000
0200000000  