12x12
000001110000
000010010000
000111010000
000001110000
000000100000
000000111000
000000001110
000000000011
000000000010
000000001110
000000011000
000000002000